5,GuardTower*9
Normal,13,16,17
0,0,0,0,0
0,6,2,6,0
0,2,0,2,0
0,6,2,6,0
0,0,0,0,0