5,BeanFarm*8
Normal,17,19
1,0,0,0,1
0,2,0,2,0
2,0,1,0,2
0,2,0,2,0
1,0,0,0,1