5,CarrotFarm*2
Normal,7,8
0,1,0,0,1
0,0,0,0,0
0,0,1,0,0
1,0,0,0,1
0,0,1,0,0